0 3 3 0 0 2 0 0 5
3 0 0 3 0 2 0 5 0
3 0 0 3 0 2 1 0 0
3 0 0 3 0 2 0 5 0
0 3 3 0 0 2 0 0 5