4 4 4 4 4 4 4 4 4
4 6 6 6 1 6 6 6 4
4 5 2 2 2 2 2 5 4
4 1 3 3 5 3 3 1 4
4 4 4 4 4 4 4 4 4
