0 4 4 3 2 6 0 0 0
0 4 5 1 2 1 6 0 0
0 2 2 2 2 2 2 2 0 
0 0 6 1 2 1 5 4 0
0 0 0 6 2 3 4 4 0
