3 2 2 2 2 2 2 2 3
3 6 4 4 4 4 4 6 3
3 6 1 5 1 5 1 6 3
3 6 4 4 4 4 4 6 3
3 2 2 2 2 2 2 2 3
