6 0 0 6 0 1 1 0 3
6 4 4 6 2 0 0 2 3
6 0 0 6 2 5 5 2 3
6 0 0 6 2 0 0 2 3
6 0 0 6 2 0 0 2 3