6 6 2 3 3 3 2 6 6
6 2 5 2 3 2 1 2 6
2 4 4 4 2 4 4 4 2
6 2 1 2 3 2 5 2 6
6 6 2 3 3 3 2 6 6