0 1 1 0 0 0 0 0 0
2 0 0 2 0 0 4 0 0
2 5 5 2 0 4 4 4 0
2 0 0 2 0 0 4 0 0
2 0 0 2 0 0 0 0 0